s00010101110111
101000100000001
100011001101011
110000000001011
100111011010001
100011001011101
101011100000011
101010000111011
100110110000011
101100000101011
100011110000001
111010000111001
100010111111001
101110100000001
11111111111110f